  ############################
  #************##************#
  #*####*#####*##*#####*####*#
  #*####*#####*##*#####*####*#
  #*####*#####*##*#####*####*#
  #$************************$#
  #*####*##*########*##*####*#
  #*####*##*########*##*####*#
  #******##****##****##******#
  ######*##### ## #####*######
       #*##### ## #####*#     
       #*##          ##*#     
       #*## ###  ### ##*#     
########*## #      # ##*########
        *   #      #   *      
########*## #      # ##*########
       #*## ######## ##*#     
       #*##          ##*#     
       #*## ######## ##*#     
  ######*## ######## ##*######
  #************##************#
  #*####*#####*##*#####*####*#
  #*####*#####*##*#####*####*#
  #***##*******@********##***#
  ###*##*##*########*##*##*###
  ###*##*##*########*##*##*###
  #******##****##****##******#
  #*##########*##*##########*#
  #*##########*##*##########*#
  #**************************#
  ############################